XXXXXXXXXXXXXXXXXXXXXXXXXXXXXXXXXXXXXXXXXXXXXXXXXXXXXXXXXXXXXXXXXXXXXXXXXXXXXXXXXXXXXXXXXXXXXXXXXXXXXXXXXXXXXXXXXXXXXXXXXXXXXXXXXXXXXXXXXXXXXXXXXXXXXXX
X           X             X   X                             X                 X     X           X       X       X           X   X     X       X       X
X XXXXX XXXXX X XXXXXXX XXX X X XXXXXXX XXXXXXX XXXXXXXXXXX X XXXXXXXXXXXXX X X XXXXX XXXXXXX X X X XXXXX XXX XXX XXXXXXX XXX X X XXX X XXX X X XXX X X
X   X   X     X   X X   X   X   X X   X       X X     X   X X       X     X X X       X       X X X X   X   X X   X       X   X X   X   X X X X X   X X
XXXXX XXX XXXXXXX X X XXX XXXXXXX X X XXXXXXX X XXX X X X X XXXXXXX XXXXX X X XXX XXXXX XXXXXXX X XXX X XXX X X XXX XXXXXXX XXX XXX XXXXX X XXX X XXX X
X     X   X   X   X     X X       X X       X X   X X   X X     X         X X   X X   X X   X   X   X X   X X   X X X         X   X X     X     X X X X
X XXXXX XXXXX X XXX XXXXX X XXXXX X XXXXXXX X XXX X XXXXX XXXXX XXXXXXXXX X XXX X X X X XXX X XXXXX X XXX X XXXXX X X XXXXXXXXX X X X XXX XXXXXXX X X X
X X           X X   X     X     X X X     X X X X X     X X   X   X     X X   X X X X   X   X   X   X   X X   X   X   X   X X   X X X   X   X   X X   X
X X XXXXXXXXXXX X XXX XXXXXXXXX XXX XXX XXX X X X XXXXX X X X XXX X XXXXX XXX X XXX XXXXX X XXX X XXXXX X XXX X X XXXXX X X X XXXXX XXX XXX X XXX X XXX
X   X   X   X   X X   X   X   X   X   X X   X   X     X X X X X   X   X   X   X     X     X   X X X     X   X   X X     X X X       X   X X   X   X   X
X XXX XXX X X XXXXX XXX X X X XXX XXX X X XXXXX XXXXX X X X X X XXXXX X XXX XXXXXXXXXXX XXXXX X X X XXXXXXX XXXXX XXX XXX X XXXXXXXXX XXX XXX X XXXXX X
X   X X   X   X     X   X X X   X X   X X X   X X   X X X   X       X   X   X           X     X X X X   X   X   X     X   X     X     X   X   X X   X X
XXX X X XXXXXXX XXXXXXX X X XXX X X XXX X X X X X XXX XXXXXXXXXXXXX XXXXX XXXXXXXXX XXXXX XXXXX X X XXX X X X X XXXXXXX XXX XXX X XXX XXX X XXX X X XXX
X X X X         X     X X   X     X   X X   X X   X   X           X X   X   X   X   X X   X     X X     X X   X X     X   X   X X   X   X X X X   X   X
X X X XXXXXXXXXXX XXX X XXXXX XXXXXXX X XXXXX XXXXX XXX XXXXXXXXX X X X XXX X X X XXX X XXX XXXXX XXXXX X XXX XXX X XXXXX XXX X XXXXXXX X X X XXXXX X X
X X       X   X   X X X     X X       X     X X   X X   X   X X   X   X X   X X   X X     X   X   X     X X   X   X     X X   X       X X   X X   X X X
X XXXXXXX X X XXX X X X XXX X X XXXXXXX XXXXX X X X X XXX X X X XXXXXXX X XXX XXXXX X XXXXXXX X XXX XXXXX X XXX XXXXXXX X X XXXXXXXXX X X XXX X X XXX X
X X     X X X     X X X X   X X   X         X X X   X     X   X X   X   X X   X   X     X     X         X X X X     X X X X   X   X     X X     X     X
X X X XXX X XXXXXXX X X X XXX XXX XXXXX XXX X X X XXXXXXX XXXXX X XXX XXX X XXX X XXXXX X XXXXX XXXXXXXXX X X XXXXX X X X X X X X X XXXXX XXX X XXXXX X
X   X X   X X       X X X   X X   X   X X   X X X X     X X   X X   X     X     X   X   X     X   X       X     X   X X   X X X X   X   X X   X   X X X
X XXX X XXX X XXXXX X XXXXX XXX XXX X XXX XXX X XXX XXX X X X X X X XXXXXXX XXXXXXX XXXXXXXXX XXXXX XXXXXXXXX XXX XXX XXXXX X X XXXXX X X X X XXX X X X
X   X       X X     X       X   X   X     X   X     X   X X X   X X       X X     X           X     X       X X   X     X   X X X     X X   X X X X   X
X XXXXXXXXXXXXX XXXXXXXXXXX X XXX X XXXXX X XXX XXXXX X X X XXXXX XXXXXXX X X XXX XXXXXXXXXXXXX XXXXX XXXXXXX X XXX X XXX XXX XXX XXXXX XXXXX X X XXX X
X X   X       X           X X X   X   X X X   X   X   X X X X   X X     X   X X       X     X     X         X X   X X X     X     X   X   X     X   X X
XXX X X XXXXX XXXXXXX XXXXX X X XXXXX X X XXX XXX X X XXX X X XXX XXX X XXXXX XXXXXXX X XXX X XXX XXXXX XXX X XXX X X X XXXXXXX XXXXX XXX XXXXX XXX X X
X   X X X   X       X X     X X     X X X X X X   X X X   X           X   X     X X   X X   X   X     X   X     X X X X   X   X         X   X X X   X X
X XXX X X X XXXXXXX X X XXXXX XXXXXXX X X X X X XXX XXX XXX XXXXXXXXXXXXX X XXX X X XXX XXX XXXXXXX X XXXXXXXXXXX X X X XXX X XXXXX XXXXX X X X X XXX X
X X     X X X     X X   X   X   X     X     X X   X X     X X   X   X   X X X   X X   X   X   X   X X   X         X X   X   X   X   X   X X X   X X   X
X X XXXXX X X X XXX X XXX XXXXX X XXXXX XXXXX XXX X X XXXXX X X X X X X X XXX XXX XXX XXX XXX X X XXX X X XXXXXXXXXXXXX X XXXXX XXXXX X XXX XXXXX X XXX
X X X     X X X     X X       X X   X X   X   X   X   X   X   X   X   X X X   X     X     X X   X   X X   X   X       X X     X X     X X   X   X X X X
X XXX XXXXX X XXXXXXX X XXXXX X XXX X XXX X XXXXXXXXXXX X X XXXXXXXXXXX X X XXX XXX XXXXXXX XXXXXXX X XXXXX X XXXXX X XXXXX X X X XXXXX X X X X X X X X
X X   X   X X X     X X X     X X   X     X   X   X     X X       X     X X   X X   X   X         X X       X       X     X X X X   X     X X X   X   X
X X X XXX X X X XXX X XXX X XXX X XXX XXXXXXX X X X XXXXX XXXXXXX X XXXXX XXX XXX X X XXX XXXXXXX X XXXXX XXXXXXXXXXXXXXX XXX X XXX XXXXXXX X XXXXXXX X
X   X     X X   X X X   X X X   X X     X X   X X   X   X     X   X X   X X   X   X X   X X   X   X X   X X   X         X   X X   X   X     X       X X
X XXX XXX X XXXXX X XXX X X X XXX XXXXX X X XXX XXXXXXX XXXXX X XXX X XXX X XXX XXX XXX X X X X XXX X X XXX X X XXX XXX XXX X XXX XXX XXXXXXXXX XXX X X
X     X   X X   X   X     X X X X   X   X X X         X   X   X   X X X   X X   X   X   X X X X   X X X     X X   X   X X X   X   X   X       X X   X X
XXX XXXXX X XXX X XXXXXXXXX X X X X X XXX X X XXXXXXX X XXX XXXXXXX X X XXX X X X XXX X X X XXXXX X X XXX XXX XXX XXX X X XXXXX XXX X X XXXXX XXX XXXXX
X   X   X X   X X X       X X X X X X X   X X   X     X   X         X   X   X X X   X X X X X     X X   X   X   X X   X       X   X X X   X X   X     X
XXXXX X XXXXX X X XXX XXX XXX X X X X X X X XXXXX XXXXXXX XXXXXXXXXXX XXX XXXXX XXX X X X X X XXXXX X X X X XXX XXX XXXXXXXXXXXXX X XXXXX X XXX XXXXX X
X     X       X       X X X   X   X X   X X X     X                 X X   X     X X   X X   X   X   X X   X X X   X     X     X   X X     X         X X
X XXXXXXX XXXXXXXXXXXXX X X XXX XXX X XXX X X XXXXXXXXX XXXXXXXXX XXX X XXX XXXXX XXXXX XXX XXX X XXXXX X X X XXX X XXX X XXX X XXX X XXXXX XXXXXXX X X
X X   X   X       X         X     X   X   X   X         X X       X   X   X X   X X   X X   X X   X     X X   X   X   X   X   X X   X     X X     X X X
X X XXX XXX XXXXX XXXXXXXXXXXXXXXXX X XXXXXXXXX XXXXXXXXX X XXXXXXX XXX X X X X X X X X X XXX XXXXXXX XXX X XXX XXXXX XXXXX XXX X X XXXXX XXX XXX X X X
X X X   X   X   X   X       X     X X   X       X     X     X X     X   X X X X X   X   X X           X   X X   X   X X   X   X X X     X X   X X X   X
X X X XXX XXX X XXX X XXXXX X XXX X XXX X XXX XXX XXX X XXXXX X XXXXX XXX X X X XXXXXXXXX X XXXXXXX XXX XXX X XXXXX X XXX XXX X X X XXX X X XXX X XXX X
X X     X X   X X X   X   X     X X X   X   X     X X X       X X   X   X X X X     X     X       X X   X   X X     X       X   X X X   X   X   X X X X
X XXXXXXX X XXX X XXXXX X XXXXXXX XXX X XXX XXXXXXX X XXXXX XXX X X X XXX X X XXXXX X XXXXXXXXXXXXX X XXXXXXX X X XXXXXXX X XXXXX X XXXXXXXXXXX X X X X
X     X     X         X X   X     X   X   X X       X X   X X   X X X X   X   X     X         X     X   X   X X X X       X     X X             X X   X
XXXXX X XXXXXXXXXXXXX X XXX X XXXXX XXXXX X XXX XXXXX X X X X XXX X X X XXX XXX XXXXXXXXXXXXX X XXXXX X X X X X XXX XXXXXXXXX X XXX XXXXX XXXXX X X XXX
X     X X X       X     X   X X     X     X     X   X   X X X     X X X X   X X X       X     X   X   X   X X X   X           X   X X   X X   X X X X X
X XXX X X X XXXXX XXXXXXXXXXX XXX X X XXXXXXXXX X X XXX X X XXXXXXX XXX X XXX X X XXX X X XXXXXXX X XXXXXXX X XXX XXXXX XXXXXXXXX X X X X X X XXX X X X
X X   X X X X               X   X X X   X     X X X   X X X     X X     X X   X   X X X X X       X       X X X     X   X   X   X X X X   X X     X X X
X XXXXX X X XXXXXXX XXXXXXX XXX X X XXX X X XXX X XXX XXX XXXXX X XXXXXXX XXX XXXXX X XXX XXX XXXXXXXXXXX X X X XXXXX XXX X X X X XXX XXXXX XXXXXXX X X
X X     X X X     X X     X     X X   X X X X   X   X   X X   X X   X   X X   X     X         X     X   X X   X   X   X   X   X X     X   X   X   X X X
X X XXXXX X X XXX XXX XXX XXXXXXXXXXX X X X X XXXXX XXX X X X X X XXX X X X XXX XXX XXXXXXX XXX X X XXX X XXXXX X X XXX XXXXXXX XXX XXX X XXX XXX X X X
X   X     X X X X   X   X X         X X   X X   X X X     X X     X   X   X X     X         X X X X     X   X   X X   X X       X   X   X X   X   X   X
X XXXXX XXX X X XXX XXX X XXXXX X X X XXXXXXXXX X X XXXXXXXXX XXXXX XXXXXXX X XXXXXXXXXXX XXX X X XXXXX XXX XXXXX XXX X X XXXXXXXXXXX XXX X XXX XXXXX X
X       X   X X   X   X X     X X X   X       X   X X       X   X   X       X X         X X   X X   X     X     X     X X     X       X X X X   X     X
XXXXXXX X X X X X X X X XXXXX XXX XXXXX XXXXX X XXX X XXXXX XXXXX XXXXXXXXX X X XXXXXXX X XXX X XXX XXXXXXXXXXX XXXXX X XXXXX X X XXXXX X X X XXX XXXXX
X     X X X X X X X X X   X X   X       X   X   X   X X X   X   X X         X X   X     X X   X   X           X     X X X     X X   X   X   X     X   X
X XXX X X XXX X X X XXXXX X XXX X XXXXXXX X XXXXX XXX X X XXX X X X X XXXXX X XXX XXX XXX X XXXXX XXXXXXXXXXX XXXXX X X XXX XXXXXXX X XXXXXXX XXXXXXX X
X   X   X   X   X X     X   X X X   X     X     X   X   X     X   X X X   X X X X   X   X X   X   X     X   X     X X X   X   X   X X       X X     X X
X XXXXXXXXX XXXXX XXX XXXXX X X XXXXX XXXXXXXXX XXX XXX XXXXXXXXXXX XXX X XXX X XXX XXX X XXX X XXX XXXXX X XXX XXX XXXXX XXX X X X X XXX XXX X X X X X
X X           X X X   X     X X     X     X   X     X   X       X       X         X X   X   X X X   X     X     X   X   X X     X   X   X   X X X X X X
XXX XXXXXXXXX X X X XXX XXXXX XXXXX XXXXX X X XXXXX X XXXXX XXX X XXXXXXXXXXXXXXXXX X XXXXX X X XXX X XXXXXXXXX X XXX X X XXXXXXXXXXXXX XXX X X X X X X
X   X X         X X   X X       X X X   X   X     X X       X   X         X X       X X     X X     X X   X   X X     X X             X   X X X X X   X
X XXX X XXXXXXXXX XXX X X XXX X X X X X XXXXX XXX XXXXXXXXXXX XXXXXXXXXXX X X XXXXXXX XXX XXX XXXXX X XXX X X X XXXXXXX XXXXXXXXXXXXX X XXX X XXX XXX X
X X         X     X X X X X   X   X   X     X   X       X   X       X       X   X   X X   X         X X   X X   X X   X         X     X X   X     X X X
X XXXXXXX XXX XXXXX X X X X XXXXXXXXXXXXXXX XXX XXX XXX X XXXXXXXXX XXXXXXXXXXX XXX X X XXXXX XXXXXXX X XXX XXXXX X X XXXXXXXXX X XXXXX X XXXXXXXXX X X
X X     X X   X     X   X X X     X         X X X X   X           X X       X   X   X X     X X   X   X     X     X X     X   X X X     X     X   X   X
X X XXX XXX XXX XXX XXXXXXX X XXX X XXXXXXXXX X X XXX XXX X XXXXX X X XXXXX X XXX XXX X XXX XXX X X XXX XXXXXXXXX X XXX XXX X X X XXXXX XXX X X X X XXX
X X   X     X   X   X       X X X   X     X     X   X   X X X   X X X X X   X   X     X   X X   X   X       X   X X   X X   X   X     X   X X   X X   X
X XXX XXXXXXX XXX X X XXX XXX X XXXXXXX XXX XXXXX X XXX X X X X X X X X X XXXXX X XXXXXXXXX X X XXXXXXXXXXX X X X XXX X X XXXXXXXXXXX XXX X XXX XXXXX X
X     X         X X X X   X   X       X X   X     X   X X X X X   X   X X X     X   X       X X X     X   X X X   X   X   X           X   X X   X     X
X XXXXXXXXXXXXXXX X XXX X X XXX XXX X X X XXX XXXXXXX X XXX X XXXXXXXXX X X XXXXXXX XXX XXXXX X X XXX X X X X XXX X XXXXXXX XXXXXXXXXXXXXXX X XXX XXXXX
P               X       X X X     X X   X X X   X   X X     X             X   X   X X   X   X X X X X   X X X X X X   X X       X X         X   X     K
XXXXXXXXXXXXXXX X X XXXXXXX XXXXX X XXXXX X X X X XXX XXXXXXXXXXXXXXXXXXXXX X XXX X X XXX X X XXX X XXXXX X X X X XXX X X XXXXX X X XXX XXXXXXX XXXXX X
X   X       X   X X X     X   X   X X     X   X X X   X         X     X   X X   X X   X   X   X   X X   X X   X   X X X   X X   X     X   X   X X   X X
XXX X XXX XXX XXX XXX XXX X X XXX X X XXXXXXXXX X X XXXXXXX XXX X X XXX X X XXX X XXXXX XXXXX X XXX X X X XXXXX XXX X X XXX X XXX XXXXXXX X XXX X X X X
X   X   X   X X   X   X X X X   X X X     X     X   X       X X X X   X X     X X           X X   X   X X   X       X X X   X   X X   X   X     X X   X
X XXXXX XXX X X XXX XXX X XXXXX XXX XXXXX X XXXXX XXXXX XXXXX X X XXX X XXXXXXX X XXXXXXX X XXXXX XXXXX XXX X XXXXXXX X X XXXXX X X X X XXX XXXXX XXXXX
X     X X X   X X   X   X       X     X X X     X     X X X   X X   X   X     X X X     X X   X           X X X       X   X     X X X X X   X   X     X
X X XXX X XXXXX X XXX XXXXXXXXXXX XXX X X XXX X XXXXX X X X X X X XXXXXXX XXX X XXX XXX XXX X X XXXXXXXXX X XXX XXXXXXX XXX XXXXXXX X X XXXXX X XXXXX X
X X       X     X X   X         X   X   X   X X     X   X   X X X X       X     X   X X   X X   X   X   X X   X     X X X   X       X X   X   X     X X
XXXXXXXXX X XXX X X X X X XXXXX X X XXXXXXX XXXXXXX XXXXX XXX X X X XXXXX XXXXXXX XXX XXX XXXXXXX X X X XXXXX XXXXX X X X X X XXXXXXX X X X XXXXXXX X X
X       X   X   X X X X X X     X X     X   X   X   X   X   X   X X     X X   X   X   X X       X X   X     X X     X X X X X   X   X X X       X   X X
X XXXXX XXXXXXXXX X XXX X XXXXXXX XXXXX X XXX X X XXX XXXXX XXXXX XXXXX XXX X X XXX X X XXXXXXX X XXXXXXXXX X X XXXXX X X XXXXX XXX X XXXXXXXXX X X X X
X X   X X       X X   X X   X     X   X   X   X X X   X     X   X     X X   X X     X X     X X     X   X   X X X   X   X     X     X     X   X X X X X
X X XXX X XXXXX X XXX X XXX X XXXXXXX XXXXX XXX X X XXX XXXXXXX XXXXX X X XXX XXXXXXX X XXX X XXXXXXX X X XXX X X X X XXXXXXX XXXXX XXXXX X X XXX X X X
X X       X   X X   X   X   X     X   X   X   X   X     X     X       X X X   X     X   X X X X       X   X X   X X X       X     X X   X   X   X X X X
X XXXXXXXXXXX X XXX X XXX X XXXXX X X X X XXX XXXXX XXXXXXX X X XXXXXXX X X X XXX X XXXXX X X X XXXXXXXXXXX X XXXXX XXXXXXX XXX X X X X XXXXXXX X XXX X
X   X       X       X X X X X X   X X X X   X   X   X     X X X X   X X   X X X   X       X   X X     X     X     X X     X X   X X X X       X X     X
XXX X XXXXX X XXXXXXX X X X X X XXX X X XXX XXX X XXX XXX X X X X X X XXXXX X X XXXXXXXXX XXX X X XXX X XXX XXXXX X X XXX X X XXX X X XXXXXXX X XXXXX X
X   X     X X X   X     X X X X X   X   X X     X X     X   X X   X   X     X   X     X   X X X X   X   X X   X   X X X X   X X X X X X   X   X X   X X
X XXXXX XXX X X X XXXXX X X X X X XXXXXXX XXXXXXX XXXXX XXXXX XXXXXXX X XXXXXXXXX XXXXX XXX X XXXXX XXXXX X XXX XXX X X XXXXX X X X XXX X X XXX X X XXX
X       X   X X X   X   X X   X   X       X     X       X X   X       X X     X     X   X   X X           X   X   X X X   X   X   X     X X   X X X   X
X XXXXXXX XXXXX XXX XXXXX XXXXXXXXX XXXXX X XXX XXXXXXXXX X XXX XXXXXXX X XXXXX XXX X XXX X X XXX XXXXXXXXXXX XXX X X X X X XXX XXXXXXXXX XXX X X XXX X
X     X X       X X X     X       X X X   X X   X         X   X X   X   X X     X X   X   X X   X X   X     X X   X     X X X       X   X     X     X X
XXXXX X XXXXXXXXX X X XXXXX XXX X X X X XXXXX X X XXXXXXX XXX XXX X X XXX X XXXXX XXXXXXXXX XXX X X X X XXX X X XXX XXXXXXX X XXXXXXX X XXX XXXXXXXXX X
X X   X           X X     X   X X   X X X     X X   X   X X   X   X   X   X X           X     X X X X   X X X   X     X     X   X     X     X       X X
X X XXXXXXX XXXXX X XXX X XXX X XXXXX X X XXXXXXXXX XXX X X XXX XXX XXXXX X XXXXXXX XXX X XXX X XXX XXXXX X X XXXXXXXXX XXXXXXXXX XXXXXXXXXXX XXXXX X X
X X       X     X X   X X     X   X   X X         X   X X   X     X X   X         X X X X   X X     X     X X         X           X   X     X X   X   X
X XXXXXXX XXXXXXX XXX X XXXXXXXXX X XXX XXXXXXX X XXX X XXXXXXXXX XXX X XXXXXXXXX X X X XXX X XXXXXXX XXX X XXXXXXXXX XXXXX XXXXXXX X X XXX X X X XXX X
X     X   X       X X X X   X     X X   X     X X   X   X       X     X       X X   X   X   X   X     X   X X       X     X X   X   X   X   X X X   X X
X X XXX XXX XXXXX X X XXX X X XXXXX X XXX XXX X X XXXXX XXXXX X XXX XXXXXXX X X XXXXX XXX XXXXX XXXXXXX XXX X XXXXX XXXXX X XXX X XXXXXXX XXX XXX XXX X
X X     X   X   X   X   X X   X     X     X   X X X   X       X   X X     X X X     X X   X   X       X X   X X X       X X     X X     X     X   X   X
X XXXXXXX X X X XXX XXX X XXXXX X XXXXXXXXX XXX X X X XXXXXXXXXXX XXX XXX XXX X XXX X XXX X X XXXXXXX X X XXX X X XXXXXXX XXX XXX XXXXX XXXXXXX XXX XXX
X X       X   X X     X X     X X       X X X X X X X X         X     X X     X   X X     X X     X   X X   X   X X       X   X   X     X X       X   X
X XXXXXXXXXXX X XXXXXXX X XXX XXX X XXX X X X X X X X X XXXXX XXXXXXXXX XXXXXXXXX X XXXXXXX XXXXXXX XXX XXX XXXXX X XXXXXXX X X XXX XXX X X XXXXX XXX X
X X         X X X       X   X   X X X     X X X X X X   X   X             X     X X     X                 X X   X X     X   X   X   X   X X   X X     X
X X XXXXXXX XXX X XXXXXXXXX XXX XXX XXX XXX X X X X XXXXX X XXXXXXX XXX XXX XXX X XXX XXX XXXXXXXXXXXXXXXXX X X X XXXXX XXX XXXXX XXX XXX XXX X XXXXXXX
X   X X     X   X X       X   X   X   X X   X   X X       X           X X   X X     X       X     X         X X     X       X       X X     X     X   X
XXXXX X XXXXX XXX XXX X XXXXX XXX X X XXX XXXXXXX XXXXXXXXXXXXXXXXXXX X X XXX XXXXXXXXXXXXX X XXXXX XXXXXXXXX XXXXX X XXX XXXXXXX X X XXX X XXXXX XXX X
X     X X       X   X X X   X X X X X   X X           X   X     X     X       X         X   X     X   X   X     X   X     X     X X X   X X     X     X
XXXXX X XXXXXXX XXX X XXX X X X X X XXX X XXX XXXXXXX X X X XXXXX XXXXXXXXXXXXX XXXXXXX X XXXXXXX XXX X X XXXXX X XXXXXXXXX XXX XXX XXX X XXX XXXXXXX X
X   X X         X   X X   X   X X X   X       X         X   X       X             X   X X           X X X       X X         X X     X X   X   X       X
X X X XXXXXXXXX X XXX X XXXXXXX X XXX XXXXXXXXXXXXX XXXXXXXXX XXXXXXX XXXXXXXXXXXXX X X XXXXXXXXX XXX X XXXXXXXXX X XXXXXXXXX XXXXXXX XXXXX XXX XXXXXXX
X X X   X       X X     X     X X   X X   X       X X X     X     X   X     X   X   X   X         X   X X       X X     X           X     X X X X     X
X X XXX X XXXXX X XXX XXXXX X X XXX X XXX X XXXXX X X X XXX XXXXX X XXX XXX X X X XXX XXXXXXXXX XXX XXX X X XXXXX XXXXX XXXXX X XXX X XXX X X X X XXXXX
X X   X   X   X X   X   X   X   X X X     X X   X X   X X X       X     X     X X X   X       X X X X   X X X   X X     X   X X X X X X   X   X X     X
X XXX X XXX X XXXXX XXX X XXXXX X X XXXXXXX X XXX XXXXX X XXXXXXXXXXXXXXX XXX X X X XXX XXXXX X X X X XXX X X X X X XXXXX X XXX X X X X X XXX X XXX X X
X   X X   X X       X   X   X     X X     X X   X               X       X     X X X X   X   X X   X X X   X   X X X X X   X     X   X X X X   X   X X X
X X X XXXXX XXXXXXXXX XXX X XXXXX X X XXX X X X XXXXXXXXXXXXXXXXX XXXXX XXXXXXX X XXX XXX X X XXXXX X X XXXXXXX X X X X X XXXXXXX XXXXX X X XXXXX XXX X
X X X       X   X     X   X   X   X   X X   X X       X       X   X   X       X X   X   X X X       X X       X   X X   X     X X     X X X X X   X   X
X X XXXXXXXXX XXX XXXXX XXXXX X XXXXXXX XXXXX XXXXX XXX XXXXX X XXX XXX XXXXXXX XXX XXX XXX XXXXXXXXX XXX XXX XXXXX XXX XXXXX X XXXXX X XXX X X XXX X X
X X   X         X X     X   X X X           X X   X X   X   X X X     X   X     X     X         X     X X   X   X     X X     X   X   X   X X X X   X X
XXXXX X XXXXXXX X XXXXX XXX X XXX XXXXXXXXX X X X X X XXX X X X XXX X XXX X XXXXX XXX XXXXXXXXX XXX XXX X X XXX XXXXX X X X X XXX X XXXXX X X X XXX X X
X     X   X   X X     X     X       X     X   X X   X   X X X X   X X X   X     X   X X         X   X   X X   X       X X X X   X         X X X     X X
X XXXXXXX X X X XXXXX XXXXXXXXXXX XXX XXX XXX X XXX XXX XXX X XXX XXX X XXXXXXX XXX XXX XXXXXXXXX XXX XXX X XXXXXXXXXXX X X XXX XXXXXXXXX X X XXXXXXX X
X X   X   X X     X   X   X     X X   X     X X X     X     X     X   X       X   X   X X           X   X X           X X X   X   X     X X     X   X X
X X X X XXX XXXXX X XXX X X XXX XXX XXXXXXX XXX XXXXXXXXXXX XXXXXXX X X XXXXX XXX XXX X X XXXXXXXXX X X X XXXXXXX XXX X XXXXX XXX X XXXXX XXXXX X X X X
X X X     X     X X X   X   X   X   X   X       X           X       X       X   X X X X X   X     X X X   X     X X   X   X     X X           X X X X X
X XXXXXXXXXXX X X X X XXXXXXX XXX XXX X X XXXXXXX XXXXX X XXX XXXXX XXXXXXXXX X X X X X XXX XXX X X X XXXXX XXX X X X XXX X XXXXX XXXXXXXXXXXXX X X X X
X           X X X X X       X   X     X X X X     X   X X   X   X   X       X X X X X   X X     X X X X     X   X X X   X X X   X             X X X X X
X XXXXXXXXX XXX XXX XXXXXXX XXX XXXXXXX X X X XXXXX X X XXX XXXXX XXX XXXXX X X X X XXXXX XXXXXXX X XXX XXXXX XXXXX XXXXX X X X XXXXXXXXXXXXX X X X X X
X   X     X   X X   X     X X           X   X X     X X   X       X   X   X   X X X         X     X     X   X   X   X   X X X X             X   X X   X
XXX X X XXXXX X X XXX XXX X X XXXXXXXXXXXXX X XXXXX X XXX XXXXXXX X XXX X XXX XXX X XXX XXXXX XXXXXXXXXXX X XXX X XXX X X X X XXXXXXXXXXX X XXXXX XXXXX
X X   X X     X     X   X   X X X         X X       X X         X X   X X X   X   X   X       X         X X   X X     X   X   X       X   X X X   X   X
X XXXXX X X XXXXXXX XXX XXXXX X X XXXXXXX XXXXXXXXXXX X XXXXXXX X XXX X XXX XXX XXXXX XXXXXXXXX XXXXXXX X XXX X XXXXXXXXX XXX X X XXXXX XXX X X XXX X X
X X   X X X X   X   X         X X     X X           X X X       X   X X   X X X   X X X   X     X   X   X   X X         X   X   X X     X X X X   X X X
X X X X X XXX X X XXX XXX XXXXX XXXXX X XXXXXXX XXXXX X XXXXX XXXXX X XXX X X XXX X X X X X X XXX XXX XXX X XXXXXXXXXXX XXX XXXXX X XXXXX X X XXX XXX X
X   X   X     X X     X X       X   X X       X       X     X X     X   X X     X X X   X X X X   X   X   X           X   X   X   X   X X   X   X   X X
X XXXXXXXXXXXXX XXXXXXX XXXXXXX X X X XXXXXXX XXXXXXXXXXXXX XXX XXXXX X X X XXXXX X XXXXX XXX XXX X XXXXX XXXXXXXXXXX XXX XXX X XXXXX X X XXX X XXX X X
X         X   X X     X         X X X     X       X   X   X X   X   X X X X X     X   X X X   X   X     X           X X   X   X X     X       X   X   X
XXXXXXXXX XXX X X XXX X XXXXXXX XXX XXXXX X XXXXX X XXX X X X XXX X XXX X X X XXXXX X X X X XXX X XXXXX XXXXX XXXXX X X XXX XXXXX XXXXXXXXXXXXXXX XXX X
X   X   X     X X   X X X     X     X     X X   X X     X X   X   X X   X   X X     X   X   X   X     X X     X   X X X X         X         X X   X   X
X X X X XXXXX X XXX X XXX XXX XXXXXXX XXXXX X X X XXX XXX XXXXX XXX X X XXXXX X X XXXXX XXXXX XXXXXXXXX XXXXXXX X XXX X XXXXXXXXX X XXXXXXX X X XXX XXX
X X X X       X   X X   X X   X       X   X   X X   X X     X X   X   X X   X X X   X     X     X     X         X X   X   X   X   X X X     X   X   X X
X X X XXXXXXXXX XXX XXX X X XXX XXXXXXX X X X XXXXX XXX XXX X XXX XXXXXXX X X X XXX XXXXXXX XXX X XXX XXXXXXXXXXX X X XXX X X XXXXX X X XXXXXXXXX XXX X
X X           X       X   X             X   X           X       X         X   X   X           X     X               X   X   X         X               X
XXXXXXXXXXXXXXXXXXXXXXXXXXXXXXXXXXXXXXXXXXXXXXXXXXXXXXXXXXXXXXXXXXXXXXXXXXXXXXXXXXXXXXXXXXXXXXXXXXXXXXXXXXXXXXXXXXXXXXXXXXXXXXXXXXXXXXXXXXXXXXXXXXXXXXX
